.............
.........1...
.0...........
........l....
.............
.............
.1...........
........0....
.............
...3.........
.....@.......
...........2.
.m...........
.............
.........1...
.............
.............
.0......m....
.............
nnr...4......
.9o...5......
#.o...6......
nnp...6......
......5......