.1....0.....1
.9..1...snnnn
0.l.....o@m..
...1.*..om...
..8.....o..m.
.1....0.o....
.b..l...o.4..
....a...qn6nn
0.......0.7..
......c......
..l.|..-...l.
.............
.............
...b.....*...
....l........
..3..........
.............
......#..2...
.............
.............
.............
ddddddddddddd
efeeeeeeeegee
jeieegeejeehe