..2..5.......
.l.l.5.3.l...
nnnnn6.nnnnn.
.....6..m....
.....5..2....
..m..6....m..
.....5..m...m
..3..5.....m@
.m...6.snnnnn
.....5.o.....
..2..6.o.....
...sn6np..0..
m..o.5.......
...o.6..3....
..mo.5.....1.
...o.7.......
nnnp....0....
.............
1.....#......
...0.........
........4....
........7....
.....1.......
.............