..1.....q..q.
.....0.......
nnnr.....@...
...o.......3.
...qnr.......
.*.2.o...0...
.8...o.......
3....o..m....
.....o....m..
...*.o.......
.2...o.......
nnnnnp.......
........1....
.1.......m...
..#..........
......0......
..........1..
nnnnnnnnnnnnn
....2........
....*........
.9...........
........3....
....*....a...
.............