.m..o8.o..6..
....o@9om.5..
....qnnp..7..
..m......0...
2............
...........1.
..s.b.-c.l...
..8........3.
..|*.........
.........c.*.
..b......|...
nnnr.....9...
...o.....t...
...o....a....
.2.o.....|...
...o.....b...
...o.........
...q.4.nnnnnn
*.....7......
.-.......3...
......a...*..
.s...........
..#.....-....
.............