.............
.9.|....u....
......l......
..t..c.......
......-..*...
.2...........
.l..snr......
....o@o...|..
....qnp......
.........3...
.............
....b.......t
.|......a....
.....-.......
.............
...u....#....
.............
..8.c.....b..
..*..-.......
.....l.....2.
.............
.............
ddddddddddddd
jeieegeejeehe