.c...........
.....*.4.l...
...2...6.....
.......5.c...
..s....6.|...
.......6.....
.8.....5.....
.......7.....
...........a.
.........t...
.2...........
.............
...9.|...c...
.............
.........|...
...........3.
.l..-..b.t...
.|...........
.....l.....9.
.............
.a........b..
.s..3........
*........8...
.............